



EA ./tex/east_ texture.xpm
NO                        ./tex/north_texture.xpm
SO   ./tex/south_texture.xpm
WE ./tex/west_texture.xpm




                 F 220,100,0
C 225,30,0

         11111111
         10000001
         10000001
11111111110000001111111111
1000000000000000000000000001
10000000000000000000000001
1000000001100N000000000011
10000000000000000011100001
10000000000000000000000001
11111111110000001111111111
         10000001
         10000001
         11111111
