
EA ./tex/east_texture.xpm
NO  ./tex/north_texture.xpm
SO   ./tex/south_texture.xpm 
WE ./tex/west_texture.xpm

F 220,100,0
C 225,30,0

        1111111111111111111111111
        1000000000110000000000001
        1111000001110000000000001
        1001000000000000000000001
111111111011000001110000000000001
100000000011000001110111111111111
11110111100000011100000010001
11110111110000011101010010001
11000000000101011100000010001
10000000000000S01100000010001
10000000000000001101010010001
110000011101010111110111100111
11110111 1110101 101111010001 
11111111 1111111 111111111111
