NO             ./tex/north_texture.xpm

SO ./tex/south_texture.xpm    

EA  ./tex/east_texture.xpm    

WE  ./tex/west_texture.xpm   

F  220 , 100 ,0  

C   225 , 30 , 1

      1 1111111  11111               1 111       1
       110000001111
         10010001
         10010001   1    1    11
         10010001
11111111110000001111111111
10000000000111000000000001
10000000000000000000100001
10000N00001111000001  1001
1000000001   1000000100001111111111
10000000001111000000000000000000001
11111111110000001111111111111111111
         10000001
         10000001
         11111111
