



NO             ./tex/north_texture.xpm

SO ./tex/south_texture.xpm    

EA  ./tex/east_texture.xpm    

WE  ./tex/west_texture.xpm   

F  220 , 100 ,0  

C   225 , 30 , 1

  



  1 11111111111111               1 111       1
       110000001111
  1      10010001
      11110010001   1   11    11
      1100100011
11111111000000111111111111111111111 1   1111
10000000000111000000000001000000001  1  1101
10000000000000000000100001111111111     1 11
11110000N00001111000001111001           111
1000000001111 111000000100011111111111  
10000000001111000000000000000000001
11111111110000001111111111111111111
         10000001
         10000001
         11111111
        