
EA ./tex/east_texture.xpm 

C 225 , 30 , 1

NO             ./tex/north_texture.xpm

SO ./tex/south_texture.xpm 

F 220 , 100 , 0

WE  ./tex/west_texture.xpm

  1 1111 1111111111   1         1 111      
       110000001111
  1      10010001          
      111100100011  1   11    11
      1100100011101                           
11111111000000111111111111111111111 1   
       100000001   
11111111110000011111111111111111111111
10000000000111000000000001000000001
1000000000000000000100001111111111          
1111000000001111000001111001    1
1000000001111 1110000100100011111111111
1000000000111100000000000N0000000001
11111111110000001111111111111111111
         10000001
         10000001
         11111111    111111